NO /home/ratavare/cub3D/assets/textures/wall_5.xpm
SO /home/ratavare/cub3D/assets/textures/wall_6.xpm
WE /home/ratavare/cub3D/assets/textures/wall_7.xpm
EA /home/ratavare/cub3D/assets/textures/wall_8.xpm

F 150,150,150
C 10,15,25

11111111111111111111111111111
10000000000000000000000001001
10000000001000010000100001001
10000000001101000000000001001
10000000000100000001000001001
10000000000000000000000001001
100001000000000W0000000000001
10000000000000000000000000001
10000100000000000000000010001
10000000000010000000000000001
11111111111111111111111111111
