NO /home/ratavare/42/cub3d/includes/textures/wall_5.xpm
NO
SO /home/ratavare/42/cub3d/includes/textures/wall_6.xpm
WE /home/ratavare/42/cub3d/includes/textures/wall_7.xpm
EA /home/ratavare/42/cub3d/includes/textures/wall_8.xpm
F 150,150,150
C 10,15,25

1111111
1001001
1010101
110W011
1010101
1001001
1111111