NO assets/textures/wall_5.xpm
SO assets/textures/wall_6.xpm
WE assets/textures/wall_7.xpm
EA assets/textures/wall_8.xpm


F 255,255,255
C 016,128,128   

1111111111
1000000001
1000000001
1001110001
1001 10001
1001010001
1001110001
1000000001
1000000001
1111111111