NO assets/textures/wall_5.xpm
SO assets/textures/wall_6.xpm
WE assets/textures/wall_7.xpm
EA assets/textures/wall_8.xpm


F 255,255,255
C 016,128,128   

1111  1111
1001111001
1000000001
1110000111
  10000
1110000111
1000000001
1000000001
1001111001
1111  1111